NO ./img/bojii.xpm
SO ./img/naru.xpm
WE ./img/visage.xpm
EA ./img/visagee.xpm

F 0,0,255
C 0,255,0

111111
10N011
100001
111111