NO ./img/bojii.xpm
SO ./img/naru.xpm
WE ./img/visage.xpm
EA ./img/visagee.xpm

F 0,0,255
C 0,255,0

1111111111
100011
1N0001
111111
